"ROOM_ID","PEOPLE_ID"
"62","201"
"62","220"
"62","240"
"62","260"
"62","261"
"62","280"
"62","281"
"62","282"
"62","283"
"62","284"
"62","285"
"62","286"
"62","287"
"62","288"
"62","289"
"62","290"
"62","291"
"62","300"
"62","301"
"62","302"
"62","303"
"62","304"
